PPPPPPPPPPPPPPPPPPPPPPPPPPPPPPPPPPPPPPPPP
P                                       P
P     S                                 P
P                                       P
P    PPPPP                PPPPPPPP      P
P                         P      P      P
PPPPPPPPPPPPPPPPPPPPPPPPPPP      P      P
                          P      P      P
                P         P             P
                PP               P      P
P           PPPPPPPPPPPPPPPPPPPPPPPPPPPPP